"filename", "language", "Python", "XML", "Markdown", "pip requirements", "SQLite", "comment", "blank", "total"
"/home/lars/Projects/music-downloader/.idea/dataSources.xml", "XML", 0, 12, 0, 0, 0, 0, 0, 12
"/home/lars/Projects/music-downloader/.idea/inspectionProfiles/profiles_settings.xml", "XML", 0, 6, 0, 0, 0, 0, 0, 6
"/home/lars/Projects/music-downloader/.idea/misc.xml", "XML", 0, 4, 0, 0, 0, 0, 0, 4
"/home/lars/Projects/music-downloader/.idea/modules.xml", "XML", 0, 8, 0, 0, 0, 0, 0, 8
"/home/lars/Projects/music-downloader/.idea/music-downloader.iml", "XML", 0, 10, 0, 0, 0, 0, 0, 10
"/home/lars/Projects/music-downloader/.idea/vcs.xml", "XML", 0, 6, 0, 0, 0, 0, 0, 6
"/home/lars/Projects/music-downloader/README.md", "Markdown", 0, 0, 75, 0, 0, 0, 34, 109
"/home/lars/Projects/music-downloader/requirements.txt", "pip requirements", 0, 0, 0, 8, 0, 0, 0, 8
"/home/lars/Projects/music-downloader/src/download.py", "Python", 59, 0, 0, 0, 0, 10, 21, 90
"/home/lars/Projects/music-downloader/src/download_links.py", "Python", 46, 0, 0, 0, 0, 3, 18, 67
"/home/lars/Projects/music-downloader/src/main.py", "Python", 78, 0, 0, 0, 0, 0, 26, 104
"/home/lars/Projects/music-downloader/src/metadata/database.py", "Python", 121, 0, 0, 0, 0, 35, 35, 191
"/home/lars/Projects/music-downloader/src/metadata/database_structure.sql", "SQLite", 0, 0, 0, 0, 48, 0, 6, 54
"/home/lars/Projects/music-downloader/src/metadata/download.py", "Python", 211, 0, 0, 0, 0, 33, 60, 304
"/home/lars/Projects/music-downloader/src/metadata/metadata.py", "Python", 106, 0, 0, 0, 0, 9, 28, 143
"/home/lars/Projects/music-downloader/src/metadata/object_handeling.py", "Python", 19, 0, 0, 0, 0, 0, 4, 23
"/home/lars/Projects/music-downloader/src/metadata/options.py", "Python", 87, 0, 0, 0, 0, 8, 24, 119
"/home/lars/Projects/music-downloader/src/musify.py", "Python", 97, 0, 0, 0, 0, 2, 37, 136
"/home/lars/Projects/music-downloader/src/phonetic_compares.py", "Python", 15, 0, 0, 0, 0, 0, 8, 23
"/home/lars/Projects/music-downloader/src/test.py", "Python", 18, 0, 0, 0, 0, 1, 6, 25
"/home/lars/Projects/music-downloader/src/url_to_path.py", "Python", 35, 0, 0, 0, 0, 6, 16, 57
"/home/lars/Projects/music-downloader/src/youtube_music.py", "Python", 63, 0, 0, 0, 0, 2, 17, 82
"Total", "-", 955, 46, 75, 8, 48, 109, 340, 1581