"filename", "language", "Python", "SQLite", "Markdown", "JSON", "comment", "blank", "total"
"/home/lars/Projects/music-downloader/.VSCodeCounter/2022-10-28_12-39-22/details.md", "Markdown", 0, 0, 31, 0, 0, 6, 37
"/home/lars/Projects/music-downloader/.VSCodeCounter/2022-10-28_12-39-22/diff-details.md", "Markdown", 0, 0, 9, 0, 0, 6, 15
"/home/lars/Projects/music-downloader/.VSCodeCounter/2022-10-28_12-39-22/diff.md", "Markdown", 0, 0, 12, 0, 0, 7, 19
"/home/lars/Projects/music-downloader/.VSCodeCounter/2022-10-28_12-39-22/results.json", "JSON", 0, 0, 0, 1, 0, 0, 1
"/home/lars/Projects/music-downloader/.VSCodeCounter/2022-10-28_12-39-22/results.md", "Markdown", 0, 0, 22, 0, 0, 7, 29
"/home/lars/Projects/music-downloader/README.md", "Markdown", 0, 0, 1, 0, 0, 1, 2
"/home/lars/Projects/music-downloader/assets/database_structure.sql", "SQLite", 0, 51, 0, 0, 0, 6, 57
"/home/lars/Projects/music-downloader/src/download.py", "Python", 1, 0, 0, 0, 1, 1, 3
"/home/lars/Projects/music-downloader/src/download_links.py", "Python", -9, 0, 0, 0, 0, -3, -12
"/home/lars/Projects/music-downloader/src/main.py", "Python", 20, 0, 0, 0, 0, 5, 25
"/home/lars/Projects/music-downloader/src/metadata/database.py", "Python", 32, 0, 0, 0, 26, 3, 61
"/home/lars/Projects/music-downloader/src/metadata/database_structure.sql", "SQLite", 0, 3, 0, 0, 0, 0, 3
"/home/lars/Projects/music-downloader/src/metadata/download.py", "Python", 59, 0, 0, 0, -9, 7, 57
"/home/lars/Projects/music-downloader/src/metadata/object_handeling.py", "Python", 0, 0, 0, 0, 0, 2, 2
"/home/lars/Projects/music-downloader/src/musify.py", "Python", 9, 0, 0, 0, 0, 3, 12
"/home/lars/Projects/music-downloader/src/url_to_path.py", "Python", -8, 0, 0, 0, 0, -3, -11
"Total", "-", 104, 54, 75, 1, 18, 48, 300